1111111111111
1001000000001
100001100P001
10ECCCC000001
1111111111111
